xxxxxxxxxxxxxxxxxxxxxxxxxxxxxxxxxxxxxxxx
x   x           x       x              x
x                       x              x
x                       x              x
x                       x              x
x                       x              x
x                x      x             px
x                       xxxx xxxxxxxxxxx
x                       x    g       x x
x                       x              x
x   xxxxx               x  x           x
x   xxxxx                   x         xx
x   xxxxx                   x          x
xxxxxxxxx                   x          x
x                           x          x
x                x          x          x
x         x xxxx            x         gx
x                          xx          x
x                                      x
xxxxxxxxxxxxxxxxxxxxxxxxxxxxxxxxxxxxxxxx
