xxxxxxxxxxxxxxxxxxxxxxxxxxxxxxxxxxxxxxxx             
x   x           x                      x
x                                      x
x                                      x
x                       xx             x
x                                      x
x               px                     x
x                                      x
x                                      x
x                                      x
x   xxxxx                              x
x   x                                  x
x   x                                  x
xxxxx                                  x
x     xx                               x
x                x                     x
x         xxxxxx                       x
x                                      x
x                                      x
xxxxxxxxxxxxxxxxxxxxxxxxxxxxxxxxxxxxxxxx             
