xxxxxxxxxxxxxxxxxxxxxxxxxxxxxxxxxxxxxxxx
x   x           x       x              x
x                       x              x
x                       x              x
x                       x              x
x                       x              x
x                x      xq            px
x                       xxxx xxxxxxxxxxx
x                       x    g       x x
x   ccccc               x              x
x   xxxxx               x  x           x
x   xxxxx                   x         xx
x   xxxxx                   x          x
xxxxxxxxx                   x          x
x                           x          x
x                x          x          x
x         x xxxx           gx          x
x                          xx          x
x                                      x
xxxxxxxxxxxxxxxxxxxxxxxxxxxxxxxxxxxxxxxx

[p] map2.txt
[q] map3.txt
