xxxxxxxxxxxxxxxxxxxxxxxxxxxxxxxxxxxxxxxx
x               x          x           x
x               x          x           x
x   xxxxxx      x          x           x
x        x      x          x           x
x        x      x          x     x     x
x               x          x   p x     x
x               x          x     x     x
x  x            x    x     x     x     x
x  x            x    x     xxxxx x     x
x  x            x    x     x     x     x
x  x            x    x     x     x     x
x  x            x    x     x     x     x
x               x          x     x     x
x               x          x  xxxx     x
x               x          x     x     x
x                       x  x     x     x
x                                      x
x                                      x
xxxxxxxxxxxxxxxxxxxxxxxxxxxxxxxxxxxxxxxx
